type octile
height 14
width 14
map
..............
..............
..............
...@......@...
..............
..............
......@@......
......@@......
..............
..............
...@......@...
..............
..............
..............
